XXXXXXXXXXXXXXXXXXXXXXXXX
P     X     X   X       X
X XXXXX X X X X X XXXXX X
X     X X X   X X   X   X
X XXX X X XXXXX XXXXX XXX
X X X   X X     X   X   X
X X XXXXX X XXXXX X XXX X
X X     X X   X   X     X
X XXX X X XXX XXX XXXXX X
X X   X X   X   X X     X
X X XXXXXXX XXX X X XXXXX
X   X       X X   X     X
XXXXX XXXXXXX XXXXXXXXX X
X     X   X           X X
X XXXXX X X XXXXXXX X X X
X X     X X     X X X X X
X X XXXXX XXXXX X X XXX X
X X X   X X   X   X     X
X X X XXX X X XXX XXXXXXX
X X   X X   X   X   X   X
X XXX X X XXXXX XXX XXX X
X   X X X   X   X   X   X
X XXX X XXXXX XXX XXX X X
X     X       X       X K
XXXXXXXXXXXXXXXXXXXXXXXXX
